inventory_id,item_id,location,case_count_on_hand,case_count_allocated,case_count_available,unit_price,date_last_sold,case_count_last_sold,date_extracted
142313,105087,PAN,20,0,20,0,0,0,Thu Oct 21 21:36:06 2021
142310,105086,PAN,154,0,154,0,0,0,Thu Oct 21 21:36:06 2021
142307,105085,PAN,20,0,20,0,0,0,Thu Oct 21 21:36:06 2021
142300,105084,MOF,47,0,47,0,0,0,Thu Oct 21 21:36:06 2021
142299,105083,DIS,32,0,32,0,0,0,Thu Oct 21 21:36:06 2021
142295,105082,DOK,32,0,32,0,0,0,Thu Oct 21 21:36:06 2021
142304,105081,PAN,27,0,27,0,0,0,Thu Oct 21 21:36:06 2021
142288,105080,MOF,139,0,139,0,0,0,Thu Oct 21 21:36:06 2021
142285,105079,HLD,4200,0,4200,0,0,0,Thu Oct 21 21:36:06 2021
142284,105078,DIS,600,0,600,0,20211021,19,Thu Oct 21 21:36:06 2021
142276,105076,MOF,720,0,720,14.81,0,0,Thu Oct 21 21:36:06 2021
142273,105075,MOF,816,0,816,11.02,0,0,Thu Oct 21 21:36:06 2021
142268,105073,MOF,61,61,0,0,0,0,Thu Oct 21 21:36:06 2021
142265,105072,MOF,13,13,0,0,0,0,Thu Oct 21 21:36:06 2021
142262,105071,MOF,16,16,0,0,0,0,Thu Oct 21 21:36:06 2021
142259,105070,MOF,94,94,0,0,0,0,Thu Oct 21 21:36:06 2021
142257,105069,MOF,510,510,0,0,0,0,Thu Oct 21 21:36:06 2021
142255,105068,MOF,170,170,0,0,0,0,Thu Oct 21 21:36:06 2021
142253,105067,MOF,170,170,0,0,0,0,Thu Oct 21 21:36:06 2021
142251,105066,MOF,1190,975,215,0,0,0,Thu Oct 21 21:36:06 2021
142249,105065,MOF,510,510,0,0,0,0,Thu Oct 21 21:36:06 2021
142245,105064,MOF,169,169,0,0,0,0,Thu Oct 21 21:36:06 2021
142242,105063,MOF,31,31,0,0,0,0,Thu Oct 21 21:36:06 2021
142239,105062,MOF,60,60,0,0,0,0,Thu Oct 21 21:36:06 2021
142237,105061,MOF,420,416,4,0,0,0,Thu Oct 21 21:36:06 2021
142235,105060,MOF,680,680,0,0,0,0,Thu Oct 21 21:36:06 2021
142232,105059,HLD,810,0,810,0,0,0,Thu Oct 21 21:36:06 2021
142229,105058,HLD,1048,0,1048,0,0,0,Thu Oct 21 21:36:06 2021
142225,105057,HLD,911,0,911,0,0,0,Thu Oct 21 21:36:06 2021
142222,105056,XTR,2835,0,2835,0,0,0,Thu Oct 21 21:36:06 2021
142219,105055,HLD,3,0,3,0,0,0,Thu Oct 21 21:36:06 2021
142216,105054,HLD,596,0,596,0,20211020,4,Thu Oct 21 21:36:06 2021
142213,105053,HLD,243,0,243,0,20211020,2,Thu Oct 21 21:36:06 2021
142210,105052,HLD,240,0,240,0,0,0,Thu Oct 21 21:36:06 2021
142209,105051,MOF,36,0,36,0,0,0,Thu Oct 21 21:36:06 2021
142206,105050,XTR,18,0,18,0,0,0,Thu Oct 21 21:36:06 2021
142203,105049,HLD,260,0,260,0,0,0,Thu Oct 21 21:36:06 2021
142200,105048,HLD,168,0,168,0,0,0,Thu Oct 21 21:36:06 2021
142197,105047,HLD,280,0,280,0,0,0,Thu Oct 21 21:36:06 2021
142194,105046,HLD,720,0,720,0,0,0,Thu Oct 21 21:36:06 2021
142191,105045,XTR,2473,0,2473,0,0,0,Thu Oct 21 21:36:06 2021
142188,105044,HLD,280,0,280,0,0,0,Thu Oct 21 21:36:06 2021
142185,105043,HLD,532,0,532,0,0,0,Thu Oct 21 21:36:06 2021
142182,105042,HLD,120,0,120,0,20211020,40,Thu Oct 21 21:36:06 2021
142179,105041,HLD,168,0,168,0,0,0,Thu Oct 21 21:36:06 2021
142176,105040,HLD,221,0,221,0,20211020,40,Thu Oct 21 21:36:06 2021
142173,105039,HLD,360,0,360,0,20211020,72,Thu Oct 21 21:36:06 2021
142170,105038,MOF,27,27,0,0,20211021,2,Thu Oct 21 21:36:06 2021
142167,105037,MOF,25,25,0,0,20211021,2,Thu Oct 21 21:36:06 2021
142164,105036,MOF,30,30,0,0,0,0,Thu Oct 21 21:36:06 2021
142161,105035,MOF,24,24,0,0,20211021,2,Thu Oct 21 21:36:06 2021
142158,105034,MOF,62,62,0,0,20211021,1,Thu Oct 21 21:36:06 2021
142155,105033,MOF,23,23,0,0,0,0,Thu Oct 21 21:36:06 2021
142152,105032,MOF,24,24,0,0,20211021,2,Thu Oct 21 21:36:06 2021
142149,105031,MOF,648,138,510,0,20211021,15,Thu Oct 21 21:36:06 2021
142146,105030,MOF,168,168,0,0,20211021,3,Thu Oct 21 21:36:06 2021
142143,105029,MOF,319,98,221,0,20211021,2,Thu Oct 21 21:36:06 2021
142140,105028,MOF,1574,68,1506,0,0,0,Thu Oct 21 21:36:06 2021
142137,105027,MOF,539,193,346,0,20211021,1,Thu Oct 21 21:36:06 2021
142130,105025,MOF,819,819,0,0,20211021,2,Thu Oct 21 21:36:06 2021
142127,105024,MOF,1327,437,890,0,20211021,100,Thu Oct 21 21:36:06 2021
142126,105023,MOF,77,77,0,0,0,0,Thu Oct 21 21:36:06 2021
142125,105022,MOF,32,32,0,0,0,0,Thu Oct 21 21:36:06 2021
142122,105021,HLD,1800,0,1800,0,0,0,Thu Oct 21 21:36:06 2021
142119,105020,HLD,101,0,101,0,20211020,2,Thu Oct 21 21:36:06 2021
142116,105019,MOF,1661,424,1237,0,20211021,4,Thu Oct 21 21:36:06 2021
142113,105018,HLD,815,0,815,0,20211020,3,Thu Oct 21 21:36:06 2021
142110,105017,MOF,750,750,0,0,20211021,10,Thu Oct 21 21:36:06 2021
142107,105016,MOF,23,23,0,0,20211021,1,Thu Oct 21 21:36:06 2021
142104,105015,MOF,17,17,0,0,20211021,1,Thu Oct 21 21:36:06 2021
142101,105014,MOF,36,36,0,0,20211021,1,Thu Oct 21 21:36:06 2021
142098,105013,MOF,32,32,0,0,20211021,2,Thu Oct 21 21:36:06 2021
142095,105012,MOF,53,53,0,0,20211021,1,Thu Oct 21 21:36:06 2021
142092,105011,MOF,2,2,0,0,0,0,Thu Oct 21 21:36:06 2021
142089,105010,MOF,7,7,0,0,20211021,1,Thu Oct 21 21:36:06 2021
142086,105009,MOF,113,113,0,0,20211021,2,Thu Oct 21 21:36:06 2021
142083,105008,MOF,24,24,0,0,20211021,1,Thu Oct 21 21:36:06 2021
142080,105007,MOF,130,130,0,0,20211021,1,Thu Oct 21 21:36:06 2021
142077,105006,MOF,31,31,0,0,20211021,1,Thu Oct 21 21:36:06 2021
142074,105005,MOF,119,119,0,0,20211021,10,Thu Oct 21 21:36:06 2021
142071,105004,MOF,150,150,0,0,20211021,5,Thu Oct 21 21:36:06 2021
142065,105002,HLD,85,0,85,0,0,0,Thu Oct 21 21:36:06 2021
142064,105001,MOF,10,10,0,0,20211021,2,Thu Oct 21 21:36:06 2021
142060,104999,HLD,290,0,290,0,20211020,49,Thu Oct 21 21:36:06 2021
142057,104998,MOF,21,21,0,0,0,0,Thu Oct 21 21:36:06 2021
142054,104997,HLD,17,0,17,0,20211020,2,Thu Oct 21 21:36:06 2021
142051,104996,XTR,48,0,48,0,0,0,Thu Oct 21 21:36:06 2021
142048,104995,XTR,912,0,912,0,0,0,Thu Oct 21 21:36:06 2021
142045,104994,MOF,42,5,37,0,0,0,Thu Oct 21 21:36:06 2021
142042,104993,MOF,34,34,0,0,20211021,1,Thu Oct 21 21:36:06 2021
142039,104992,HLD,305,0,305,0,20211020,5,Thu Oct 21 21:36:06 2021
142036,104991,HLD,96,0,96,0,0,0,Thu Oct 21 21:36:06 2021
142034,104990,MOF,65,65,0,0,20211021,4,Thu Oct 21 21:36:06 2021
142028,104988,HLD,314,0,314,0,20211020,200,Thu Oct 21 21:36:06 2021
142025,104987,MOF,89,89,0,0,0,0,Thu Oct 21 21:36:06 2021
142022,104986,MOF,7,7,0,0,20211021,25,Thu Oct 21 21:36:06 2021
142013,104983,HLD,1635,0,1635,0,0,0,Thu Oct 21 21:36:06 2021
142010,104982,HLD,2037,0,2037,0,20211020,196,Thu Oct 21 21:36:06 2021
142007,104981,MOF,119,119,0,0,20211021,25,Thu Oct 21 21:36:06 2021
142004,104980,MOF,122,122,0,0,20211021,23,Thu Oct 21 21:36:06 2021
142001,104979,MOF,19,19,0,0,20211021,2,Thu Oct 21 21:36:06 2021
141992,104976,MOF,165,165,0,0,20211021,2,Thu Oct 21 21:36:06 2021
141989,104975,MOF,5,5,0,0,20211021,45,Thu Oct 21 21:36:06 2021
141986,104974,MOF,41,41,0,0,20211021,3,Thu Oct 21 21:36:06 2021
141983,104973,MOF,27,27,0,0,20211021,5,Thu Oct 21 21:36:06 2021
141980,104972,MOF,667,667,0,0,20211021,9,Thu Oct 21 21:36:06 2021
141977,104971,HLD,52,0,52,0,0,0,Thu Oct 21 21:36:06 2021
141974,104970,MOF,299,101,198,0,0,0,Thu Oct 21 21:36:06 2021
141971,104969,MOF,51,51,0,0,0,0,Thu Oct 21 21:36:06 2021
141968,104968,MOF,375,375,0,0,20211021,2,Thu Oct 21 21:36:06 2021
141965,104967,MOF,108,108,0,0,20211021,2,Thu Oct 21 21:36:06 2021
141962,104966,MOF,1,1,0,0,20211021,4,Thu Oct 21 21:36:06 2021
141961,104965,MOF,20,20,0,0,20211021,1,Thu Oct 21 21:36:06 2021
141959,104964,MOF,25,25,0,0,20211021,10,Thu Oct 21 21:36:06 2021
141956,104963,MOF,496,496,0,0,20211021,11,Thu Oct 21 21:36:06 2021
141953,104962,MOF,101,101,0,0,20211021,5,Thu Oct 21 21:36:06 2021
141950,104961,MOF,545,545,0,0,20211021,11,Thu Oct 21 21:36:06 2021
141947,104960,MOF,125,125,0,0,20211021,4,Thu Oct 21 21:36:06 2021
141942,104958,MOF,65,65,0,0,20211021,1,Thu Oct 21 21:36:06 2021
141939,104957,MOF,36,36,0,0,20211021,6,Thu Oct 21 21:36:06 2021
141934,104955,MOF,218,218,0,0,20211021,100,Thu Oct 21 21:36:06 2021
141929,104954,MOF,1019,502,517,0,20211021,100,Thu Oct 21 21:36:06 2021
141926,104953,HLD,129,0,129,0,20211020,3,Thu Oct 21 21:36:06 2021
141923,104952,XTR,1917,0,1917,0,0,0,Thu Oct 21 21:36:06 2021
141920,104951,XTR,918,0,918,14.73,0,0,Thu Oct 21 21:36:06 2021
141914,104949,MOF,75,0,75,0,0,0,Thu Oct 21 21:36:06 2021
141911,104948,MOF,37,37,0,0,20211021,2,Thu Oct 21 21:36:06 2021
141908,104947,MOF,61,61,0,0,20211021,20,Thu Oct 21 21:36:06 2021
141899,104944,MOF,49,49,0,0,20211021,5,Thu Oct 21 21:36:06 2021
141896,104943,MOF,13,13,0,0,20211021,4,Thu Oct 21 21:36:06 2021
141893,104942,MOF,43,43,0,0,20211021,2,Thu Oct 21 21:36:06 2021
141890,104941,MOF,44,44,0,0,20211021,274,Thu Oct 21 21:36:06 2021
141885,104939,MOF,534,534,0,0,20211021,2,Thu Oct 21 21:36:06 2021
141882,104938,MOF,669,409,260,0,20211021,4,Thu Oct 21 21:36:06 2021
141879,104937,XTR,1344,0,1344,0,0,0,Thu Oct 21 21:36:06 2021
141876,104936,HLD,32,0,32,0,20211018,16,Thu Oct 21 21:36:06 2021
141864,104932,MOF,337,337,0,0,20211021,2,Thu Oct 21 21:36:06 2021
141862,104931,MOF,47,47,0,0,20211021,14,Thu Oct 21 21:36:06 2021
141856,104929,MOF,45,45,0,0,20211020,20,Thu Oct 21 21:36:06 2021
141853,104928,MOF,46,46,0,0,20211021,4,Thu Oct 21 21:36:06 2021
141850,104927,MOF,4,4,0,0,20211021,2,Thu Oct 21 21:36:06 2021
141847,104926,MOF,10,10,0,0,20211021,4,Thu Oct 21 21:36:06 2021
141844,104925,MOF,65,65,0,0,20211021,15,Thu Oct 21 21:36:06 2021
141841,104924,MOF,28,28,0,0,20211021,1,Thu Oct 21 21:36:06 2021
141838,104923,MOF,31,31,0,0,20211020,8,Thu Oct 21 21:36:06 2021
141835,104922,MOF,46,46,0,0,20211021,2,Thu Oct 21 21:36:06 2021
141832,104921,MOF,528,528,0,0,20211021,2,Thu Oct 21 21:36:06 2021
141829,104920,MOF,739,739,0,0,20211021,8,Thu Oct 21 21:36:06 2021
141826,104919,MOF,240,240,0,0,20211021,5,Thu Oct 21 21:36:06 2021
141823,104918,MOF,300,300,0,0,20211021,66,Thu Oct 21 21:36:06 2021
141819,104916,DIS,2,2,0,0,20211018,8,Thu Oct 21 21:36:06 2021
141817,104916,HLD,32,0,32,0,20211020,15,Thu Oct 21 21:36:06 2021
141814,104915,MOF,259,259,0,0,20211021,60,Thu Oct 21 21:36:06 2021
141811,104914,MOF,223,223,0,0,20211021,38,Thu Oct 21 21:36:06 2021
141808,104913,REC,600,0,600,0,0,0,Thu Oct 21 21:36:06 2021
141805,104912,REC,475,0,475,0,0,0,Thu Oct 21 21:36:06 2021
141799,104910,REC,450,0,450,0,0,0,Thu Oct 21 21:36:06 2021
141796,104909,REC,225,0,225,0,0,0,Thu Oct 21 21:36:06 2021
141793,104908,REC,225,0,225,0,0,0,Thu Oct 21 21:36:06 2021
141790,104907,HLD,52,0,52,0,20211020,8,Thu Oct 21 21:36:06 2021
141787,104906,HLD,24,0,24,0,0,0,Thu Oct 21 21:36:06 2021
141781,104904,HLD,72,0,72,0,20211014,72,Thu Oct 21 21:36:06 2021
141775,104902,HLD,7,0,7,0,20211019,24,Thu Oct 21 21:36:06 2021
141771,104901,MOF,2,2,0,0,20211021,3,Thu Oct 21 21:36:06 2021
141768,104900,MOF,20,20,0,0,20211019,10,Thu Oct 21 21:36:06 2021
141762,104898,MOF,17,5,12,0,20211021,12,Thu Oct 21 21:36:06 2021
141753,104895,MOF,17,17,0,0,20211021,1,Thu Oct 21 21:36:06 2021
141750,104894,MOF,35,35,0,0,20211021,12,Thu Oct 21 21:36:06 2021
141747,104893,MOF,13,13,0,0,20211020,8,Thu Oct 21 21:36:06 2021
141741,104891,MOF,8,8,0,0,20211021,2,Thu Oct 21 21:36:06 2021
141735,104889,MOF,11,11,0,0,20211020,1,Thu Oct 21 21:36:06 2021
141732,104888,MOF,66,66,0,0,20211021,2,Thu Oct 21 21:36:06 2021
141726,104886,MOF,126,33,93,0,20211020,10,Thu Oct 21 21:36:06 2021
141717,104883,MOF,32,32,0,0,20211021,4,Thu Oct 21 21:36:06 2021
141714,104882,MOF,11,11,0,0,20211021,2,Thu Oct 21 21:36:06 2021
141711,104881,MOF,45,45,0,0,20211021,3,Thu Oct 21 21:36:06 2021
141705,104879,MOF,27,27,0,0,20211021,4,Thu Oct 21 21:36:06 2021
141702,104878,MOF,30,30,0,0,20211020,4,Thu Oct 21 21:36:06 2021
141696,104876,MOF,19,19,0,0,20211021,1,Thu Oct 21 21:36:06 2021
141693,104875,MOF,13,13,0,0,20211021,1,Thu Oct 21 21:36:06 2021
141690,104874,MOF,19,19,0,0,20211021,1,Thu Oct 21 21:36:06 2021
141687,104873,MOF,6,6,0,0,20211020,13,Thu Oct 21 21:36:06 2021
141684,104872,MOF,15,15,0,0,20211020,4,Thu Oct 21 21:36:06 2021
141681,104871,MOF,20,20,0,0,20211018,10,Thu Oct 21 21:36:06 2021
141678,104870,MOF,10,10,0,0,20211021,4,Thu Oct 21 21:36:06 2021
141675,104869,XTR,1000,0,1000,0,0,0,Thu Oct 21 21:36:06 2021
141669,104867,HLD,234,0,234,0,20211020,2,Thu Oct 21 21:36:06 2021
141660,104864,HLD,37,0,37,0,20211014,45,Thu Oct 21 21:36:06 2021
141654,104862,MOF,1390,131,1259,0,20211021,100,Thu Oct 21 21:36:06 2021
141651,104861,REC,1025,0,1025,0,0,0,Thu Oct 21 21:36:06 2021
141648,104860,MOF,80,80,0,0,20211021,20,Thu Oct 21 21:36:06 2021
141645,104859,MOF,78,78,0,0,20211021,2,Thu Oct 21 21:36:06 2021
141642,104858,MOF,5,5,0,0,20211019,2,Thu Oct 21 21:36:06 2021
141640,104857,DOK,384,0,384,0,0,0,Thu Oct 21 21:36:06 2021
141639,104857,REC,960,0,960,0,0,0,Thu Oct 21 21:36:06 2021
141615,104849,MOF,501,117,384,0,20211021,6,Thu Oct 21 21:36:06 2021
141612,104848,MOF,485,123,362,0,20211021,6,Thu Oct 21 21:36:06 2021
141606,104846,MOF,119,119,0,0,20211021,1,Thu Oct 21 21:36:06 2021
141597,104843,MOF,297,297,0,0,20211021,25,Thu Oct 21 21:36:06 2021
141594,104842,MOF,16,16,0,0,20211021,25,Thu Oct 21 21:36:06 2021
141591,104841,MOF,16,16,0,0,20211021,25,Thu Oct 21 21:36:06 2021
141585,104839,MOF,180,180,0,0,20211021,25,Thu Oct 21 21:36:06 2021
141582,104838,MOF,10,10,0,0,20211014,145,Thu Oct 21 21:36:06 2021
141573,104835,MOF,181,181,0,0,20211021,2,Thu Oct 21 21:36:06 2021
141570,104834,MOF,109,109,0,0,20211021,15,Thu Oct 21 21:36:06 2021
141567,104833,MOF,1676,806,870,0,20211021,30,Thu Oct 21 21:36:06 2021
141561,104831,MOF,23,23,0,0,20211019,1,Thu Oct 21 21:36:06 2021
141555,104829,MOF,11,11,0,0,20211021,5,Thu Oct 21 21:36:06 2021
141536,104821,HLD,40,0,40,0,20211012,32,Thu Oct 21 21:36:06 2021
141533,104820,HLD,7,0,7,0,20211013,10,Thu Oct 21 21:36:06 2021
141527,104818,HLD,18,0,18,0,20211012,378,Thu Oct 21 21:36:06 2021
141521,104816,MOF,8,8,0,0,20211021,5,Thu Oct 21 21:36:06 2021
141518,104815,MOF,23,23,0,0,20211021,5,Thu Oct 21 21:36:06 2021
141515,104814,MOF,6,6,0,0,20211021,2,Thu Oct 21 21:36:06 2021
141509,104812,MOF,5,5,0,0,20211021,1,Thu Oct 21 21:36:06 2021
141506,104811,MOF,5,5,0,0,20211020,1,Thu Oct 21 21:36:06 2021
141503,104810,MOF,1,1,0,0,20211021,2,Thu Oct 21 21:36:06 2021
141495,104807,MOF,21,21,0,0,20211021,10,Thu Oct 21 21:36:06 2021
141492,104806,HLD,12,0,12,0,20211012,5,Thu Oct 21 21:36:06 2021
141489,104805,MOF,8,6,2,0,0,0,Thu Oct 21 21:36:06 2021
141486,104804,MOF,604,116,488,0,20211021,12,Thu Oct 21 21:36:06 2021
141483,104803,XTR,2160,0,2160,0,0,0,Thu Oct 21 21:36:06 2021
141479,104801,REC,1254,1254,0,0,20211021,201,Thu Oct 21 21:36:06 2021
141478,104800,REC,80,80,0,0,20211021,50,Thu Oct 21 21:36:06 2021
141475,104799,HLD,15,0,15,0,20211012,40,Thu Oct 21 21:36:06 2021
141467,104796,HLD,23,0,23,0,20211012,7,Thu Oct 21 21:36:06 2021
141460,104794,HLD,2,0,2,0,20211018,40,Thu Oct 21 21:36:06 2021
141448,104790,MOF,11,11,0,0,20211021,2,Thu Oct 21 21:36:06 2021
141436,104786,XTR,2473,0,2473,0,0,0,Thu Oct 21 21:36:06 2021
141433,104785,HLD,3,0,3,0,20211013,53,Thu Oct 21 21:36:06 2021
141424,104782,MOF,3,3,0,0,20211021,1,Thu Oct 21 21:36:06 2021
141421,104781,MOF,72,17,55,0,20211021,2,Thu Oct 21 21:36:06 2021
141418,104780,MOF,5,5,0,0,20211019,2,Thu Oct 21 21:36:06 2021
141415,104779,MOF,5,5,0,0,20211019,3,Thu Oct 21 21:36:06 2021
141412,104778,MOF,2,2,0,0,20211020,9,Thu Oct 21 21:36:06 2021
141409,104777,MOF,27,27,0,0,20211021,2,Thu Oct 21 21:36:06 2021
141406,104776,MOF,3,3,0,0,20211014,4,Thu Oct 21 21:36:06 2021
141403,104775,MOF,15,15,0,0,20211021,2,Thu Oct 21 21:36:06 2021
141400,104774,MOF,10,10,0,0,20211021,15,Thu Oct 21 21:36:06 2021
141394,104772,MOF,49,49,0,0,20211021,7,Thu Oct 21 21:36:06 2021
141391,104771,MOF,2,2,0,0,20211021,1,Thu Oct 21 21:36:06 2021
141390,104770,MOF,3,3,0,0,20211021,10,Thu Oct 21 21:36:06 2021
141372,104764,MOF,243,243,0,0,20211021,10,Thu Oct 21 21:36:06 2021
141369,104763,XTR,2387,0,2387,0,0,0,Thu Oct 21 21:36:06 2021
141363,104761,MOF,2935,197,2738,0,20211021,2,Thu Oct 21 21:36:06 2021
141347,104751,MOF,2,2,0,0,20211021,2,Thu Oct 21 21:36:06 2021
141344,104750,MOF,5,5,0,0,20211021,10,Thu Oct 21 21:36:06 2021
141341,104749,MOF,15,15,0,0,20211020,1,Thu Oct 21 21:36:06 2021
141338,104748,MOF,5,5,0,0,20211014,5,Thu Oct 21 21:36:06 2021
141335,104747,MOF,1,1,0,0,20211020,4,Thu Oct 21 21:36:06 2021
141323,104743,XTR,2160,0,2160,0,0,0,Thu Oct 21 21:36:06 2021
141322,104742,MOF,1772,280,1492,0,20211021,1,Thu Oct 21 21:36:06 2021
141315,104741,MOF,524,524,0,0,20211021,40,Thu Oct 21 21:36:06 2021
141309,104739,MOF,5,5,0,0,20211020,2,Thu Oct 21 21:36:06 2021
141306,104738,MOF,3,3,0,0,20211021,11,Thu Oct 21 21:36:06 2021
141303,104737,MOF,48,48,0,0,20211021,4,Thu Oct 21 21:36:06 2021
141285,104731,MOF,42,42,0,0,20211021,6,Thu Oct 21 21:36:06 2021
141282,104730,MOF,5,5,0,0,20211021,2,Thu Oct 21 21:36:06 2021
141279,104729,MOF,11,11,0,0,20211021,5,Thu Oct 21 21:36:06 2021
141276,104728,MOF,5,5,0,0,20211015,5,Thu Oct 21 21:36:06 2021
141273,104727,MOF,1,1,0,0,20211019,23,Thu Oct 21 21:36:06 2021
141270,104726,MOF,4,4,0,0,20211021,4,Thu Oct 21 21:36:06 2021
141267,104725,MOF,6,6,0,0,20211020,2,Thu Oct 21 21:36:06 2021
141264,104724,MOF,54,54,0,0,20211021,16,Thu Oct 21 21:36:06 2021
141263,104723,MOF,2,2,0,0,20211020,2,Thu Oct 21 21:36:06 2021
141260,104722,HLD,17,0,17,0,0,0,Thu Oct 21 21:36:06 2021
141257,104721,MOF,40,40,0,0,20211021,4,Thu Oct 21 21:36:06 2021
141242,104716,MOF,9,9,0,0,20211019,6,Thu Oct 21 21:36:06 2021
141235,104713,HLD,80,0,80,0,20211005,80,Thu Oct 21 21:36:06 2021
141232,104712,MOF,5,0,5,0,20211015,1,Thu Oct 21 21:36:06 2021
141229,104711,MOF,24,24,0,0,20211021,2,Thu Oct 21 21:36:06 2021
141222,104709,MOF,1,1,0,0,20211021,1,Thu Oct 21 21:36:06 2021
141219,104708,MOF,199,199,0,0,20211021,4,Thu Oct 21 21:36:06 2021
141216,104707,MOF,21,21,0,0,20211021,6,Thu Oct 21 21:36:06 2021
141213,104706,MOF,138,138,0,0,20211021,3,Thu Oct 21 21:36:06 2021
141210,104705,MOF,281,281,0,0,20211021,100,Thu Oct 21 21:36:06 2021
141202,104703,MOF,5,5,0,0,20211019,10,Thu Oct 21 21:36:06 2021
141199,104702,MOF,877,108,769,0,20211021,100,Thu Oct 21 21:36:06 2021
141196,104701,MOF,1,1,0,22.74,20211021,2,Thu Oct 21 21:36:06 2021
141193,104700,MOF,25,25,0,0,20211021,4,Thu Oct 21 21:36:06 2021
141190,104699,MOF,44,44,0,18.42,20211021,8,Thu Oct 21 21:36:06 2021
141187,104698,MOF,289,13,276,25.86,20211021,10,Thu Oct 21 21:36:06 2021
141184,104697,MOF,95,30,65,17.19,20211021,18,Thu Oct 21 21:36:06 2021
141175,104694,HLD,71,0,71,0,20211001,6,Thu Oct 21 21:36:06 2021
141157,104688,MOF,53,53,0,0,20211021,15,Thu Oct 21 21:36:06 2021
141151,104686,MOF,32,32,0,0,20211021,1,Thu Oct 21 21:36:06 2021
141148,104685,MOF,38,38,0,0,20211021,20,Thu Oct 21 21:36:06 2021
141130,104679,MOF,3,3,0,0,20211021,1,Thu Oct 21 21:36:06 2021
141127,104678,MOF,8,8,0,0,20211020,2,Thu Oct 21 21:36:06 2021
141124,104677,MOF,8,8,0,0,20211021,2,Thu Oct 21 21:36:06 2021
141118,104675,MOF,2,2,0,0,20211020,2,Thu Oct 21 21:36:06 2021
141106,104671,MOF,5,0,5,0,0,0,Thu Oct 21 21:36:06 2021
141099,104669,MOF,114,114,0,0,20211021,5,Thu Oct 21 21:36:06 2021
141102,104668,REC,1,0,1,0,0,0,Thu Oct 21 21:36:06 2021
141096,104668,XTR,1343,0,1343,0,0,0,Thu Oct 21 21:36:06 2021
141078,104662,MOF,115,115,0,0,20211021,10,Thu Oct 21 21:36:06 2021
141075,104661,MOF,57,57,0,0,20211021,6,Thu Oct 21 21:36:06 2021
141072,104660,MOF,24,24,0,0,20211021,2,Thu Oct 21 21:36:06 2021
141069,104659,MOF,837,837,0,0,20211021,6,Thu Oct 21 21:36:06 2021
141066,104658,MOF,169,169,0,0,20211021,2,Thu Oct 21 21:36:06 2021
141063,104657,MOF,296,296,0,0,20211020,6,Thu Oct 21 21:36:06 2021
141060,104656,MOF,1082,1082,0,0,20211021,6,Thu Oct 21 21:36:06 2021
141051,104653,MOF,11,10,1,0,0,0,Thu Oct 21 21:36:06 2021
141042,104650,MOF,3,3,0,0,20211013,2,Thu Oct 21 21:36:06 2021
141036,104648,MOF,1,1,0,0,20211020,2,Thu Oct 21 21:36:06 2021
141033,104647,MOF,7,7,0,0,20211021,2,Thu Oct 21 21:36:06 2021
141030,104646,MOF,2,2,0,0,20211021,4,Thu Oct 21 21:36:06 2021
141021,104643,MOF,21,21,0,0,20211021,3,Thu Oct 21 21:36:06 2021
141018,104642,MOF,14,14,0,0,20211020,6,Thu Oct 21 21:36:06 2021
141009,104639,REC,1500,443,1057,0,0,0,Thu Oct 21 21:36:06 2021
141006,104638,MOF,2120,625,1495,0,20211021,2,Thu Oct 21 21:36:06 2021
141000,104636,MOF,1065,222,843,0,20211021,8,Thu Oct 21 21:36:06 2021
140988,104632,MOF,3,1,2,0,0,0,Thu Oct 21 21:36:06 2021
140985,104631,MOF,34,34,0,0,20211021,1,Thu Oct 21 21:36:06 2021
140976,104628,MOF,7,7,0,0,20211021,4,Thu Oct 21 21:36:06 2021
140973,104627,MOF,43,43,0,0,20211021,20,Thu Oct 21 21:36:06 2021
140970,104626,MOF,161,78,83,0,20211021,4,Thu Oct 21 21:36:06 2021
140967,104625,MOF,39,39,0,0,20211020,6,Thu Oct 21 21:36:06 2021
140961,104623,MOF,9,9,0,0,20211015,10,Thu Oct 21 21:36:06 2021
140958,104622,MOF,8,8,0,0,20211019,1,Thu Oct 21 21:36:06 2021
140944,104617,MOF,67,67,0,0,20211021,3,Thu Oct 21 21:36:06 2021
140941,104616,MOF,1,1,0,0,20211015,0,Thu Oct 21 21:36:06 2021
140940,104615,XTR,1259,0,1259,0,0,0,Thu Oct 21 21:36:06 2021
140935,104614,MOF,1486,384,1102,0,20211021,5,Thu Oct 21 21:36:06 2021
140932,104613,MOF,708,547,161,0,20211021,2,Thu Oct 21 21:36:06 2021
140929,104612,MOF,1833,703,1130,0,20211021,2,Thu Oct 21 21:36:06 2021
140903,104590,MOF,25,25,0,0,20211008,1,Thu Oct 21 21:36:06 2021
140900,104589,MOF,25,25,0,0,20211021,1,Thu Oct 21 21:36:06 2021
140897,104588,MOF,5,5,0,0,20211012,3,Thu Oct 21 21:36:06 2021
140894,104587,MOF,7,7,0,0,20211012,3,Thu Oct 21 21:36:06 2021
140891,104586,MOF,5,5,0,0,20211012,6,Thu Oct 21 21:36:06 2021
140885,104584,MOF,50,50,0,0,20211021,6,Thu Oct 21 21:36:06 2021
140876,104581,HLD,8,0,8,0,20211005,12,Thu Oct 21 21:36:06 2021
142314,104577,MOF,1620,0,1620,0,0,0,Thu Oct 21 21:36:06 2021
140862,104575,MOF,12,0,12,0,0,0,Thu Oct 21 21:36:06 2021
140858,104573,MOF,78,78,0,0,20211021,10,Thu Oct 21 21:36:06 2021
140855,104572,MOF,4,4,0,0,0,0,Thu Oct 21 21:36:06 2021
140849,104570,MOF,11,11,0,0,20211020,1,Thu Oct 21 21:36:06 2021
140843,104568,MOF,11,11,0,0,20211019,2,Thu Oct 21 21:36:06 2021
140840,104567,MOF,18,18,0,0,20211021,2,Thu Oct 21 21:36:06 2021
140837,104566,MOF,13,13,0,0,20211021,2,Thu Oct 21 21:36:06 2021
140834,104565,MOF,4,4,0,0,20211020,10,Thu Oct 21 21:36:06 2021
140831,104564,MOF,1,1,0,0,20211021,1,Thu Oct 21 21:36:06 2021
140816,104559,MOF,2,2,0,0,20211018,6,Thu Oct 21 21:36:06 2021
140798,104553,MOF,5,5,0,0,20211020,1,Thu Oct 21 21:36:06 2021
140768,104543,MOF,16,16,0,0,20211021,5,Thu Oct 21 21:36:06 2021
140765,104542,MOF,26,26,0,0,0,0,Thu Oct 21 21:36:06 2021
140747,104536,MOF,3,3,0,0,20211015,25,Thu Oct 21 21:36:06 2021
140741,104534,MOF,5,5,0,0,20211015,10,Thu Oct 21 21:36:06 2021
140735,104532,MOF,35,35,0,0,20211021,3,Thu Oct 21 21:36:06 2021
140728,104530,HLD,150,150,0,0,20211019,63,Thu Oct 21 21:36:06 2021
140725,104529,HLD,903,0,903,0,20210923,1251,Thu Oct 21 21:36:06 2021
140715,104526,MOF,1,1,0,0,20211019,6,Thu Oct 21 21:36:06 2021
140709,104524,MOF,2,2,0,0,20211014,34,Thu Oct 21 21:36:06 2021
140706,104523,HLD,5,0,5,0,20210922,1,Thu Oct 21 21:36:06 2021
140688,104517,HLD,149,0,149,0,20210922,200,Thu Oct 21 21:36:06 2021
140656,104506,MOF,1,1,0,0,20211021,1,Thu Oct 21 21:36:06 2021
140638,104500,MOF,2,2,0,0,20211020,1,Thu Oct 21 21:36:06 2021
140633,104498,MOF,3,3,0,0,20211021,3,Thu Oct 21 21:36:06 2021
140627,104496,HLD,50,0,50,0,20210920,550,Thu Oct 21 21:36:06 2021
140622,104495,MOF,29,29,0,0,20211020,6,Thu Oct 21 21:36:06 2021
140619,104494,MOF,13,13,0,0,20211021,6,Thu Oct 21 21:36:06 2021
140616,104493,XTR,2880,0,2880,0,0,0,Thu Oct 21 21:36:06 2021
140731,104491,MOF,664,284,380,0,20211021,10,Thu Oct 21 21:36:06 2021
140601,104488,MOF,22,15,7,0,20211021,15,Thu Oct 21 21:36:06 2021
140598,104487,MOF,1,0,1,0,0,0,Thu Oct 21 21:36:06 2021
140592,104485,MOF,97,82,15,0,20211021,8,Thu Oct 21 21:36:06 2021
140580,104481,MOF,671,7,664,0,20211015,4,Thu Oct 21 21:36:06 2021
140568,104477,MOF,1,1,0,0,20211019,2,Thu Oct 21 21:36:06 2021
140559,104474,MOF,5,5,0,0,20211020,1,Thu Oct 21 21:36:06 2021
140550,104471,MOF,2,2,0,0,20211019,1,Thu Oct 21 21:36:06 2021
140529,104464,MOF,2,2,0,0,20211018,16,Thu Oct 21 21:36:06 2021
140523,104462,MOF,2,2,0,0,20211006,1,Thu Oct 21 21:36:06 2021
140508,104457,REC,1620,0,1620,0,0,0,Thu Oct 21 21:36:06 2021
140487,104450,MOF,7,7,0,0,20211019,2,Thu Oct 21 21:36:06 2021
140481,104448,MOF,2,2,0,0,20211015,2,Thu Oct 21 21:36:06 2021
140478,104447,MOF,5,5,0,0,20211014,5,Thu Oct 21 21:36:06 2021
140464,104442,MOF,89,89,0,0,20211021,4,Thu Oct 21 21:36:06 2021
140455,104439,REC,1440,0,1440,0,0,0,Thu Oct 21 21:36:06 2021
140433,104432,MOF,133,133,0,0,20211021,2,Thu Oct 21 21:36:06 2021
140421,104428,HLD,7,0,7,0,20210921,34,Thu Oct 21 21:36:06 2021
140412,104425,HLD,5389,0,5389,0,20210921,1,Thu Oct 21 21:36:06 2021
140409,104424,MOF,3,3,0,0,20211021,0,Thu Oct 21 21:36:06 2021
140391,104418,MOF,5,5,0,0,20211019,5,Thu Oct 21 21:36:06 2021
140385,104416,MOF,1558,392,1166,0,20211021,2,Thu Oct 21 21:36:06 2021
140379,104414,HLD,147,0,147,0,20211020,1,Thu Oct 21 21:36:06 2021
140364,104409,MOF,12,12,0,0,20211019,6,Thu Oct 21 21:36:06 2021
140350,104399,MOF,14,14,0,0,20211020,2,Thu Oct 21 21:36:06 2021
140331,104395,MOF,902,167,735,0,20211021,20,Thu Oct 21 21:36:06 2021
140322,104392,HLD,1,0,1,0,20210916,1,Thu Oct 21 21:36:06 2021
140319,104391,MOF,466,422,44,0,20211021,1,Thu Oct 21 21:36:06 2021
140315,104390,MOF,45,45,0,0,20211021,2,Thu Oct 21 21:36:06 2021
140311,104388,MOF,691,324,367,0,20211021,110,Thu Oct 21 21:36:06 2021
140274,104377,MOF,3,3,0,0,20211014,5,Thu Oct 21 21:36:06 2021
140271,104376,MOF,1,1,0,0,0,0,Thu Oct 21 21:36:06 2021
140255,104371,REC,1530,0,1530,0,0,0,Thu Oct 21 21:36:06 2021
140252,104370,MOF,27,27,0,0,20211021,5,Thu Oct 21 21:36:06 2021
140249,104369,MOF,270,211,59,0,20211021,40,Thu Oct 21 21:36:06 2021
140246,104368,MOF,29,28,1,0,20211021,1,Thu Oct 21 21:36:06 2021
140236,104365,MOF,1,1,0,0,20211021,1,Thu Oct 21 21:36:06 2021
140230,104363,MOF,2,2,0,0,20211020,5,Thu Oct 21 21:36:06 2021
140227,104362,MOF,49,49,0,0,20211021,28,Thu Oct 21 21:36:06 2021
140218,104359,MOF,2,2,0,0,20211021,7,Thu Oct 21 21:36:06 2021
140212,104357,MOF,78,78,0,0,20211021,2,Thu Oct 21 21:36:06 2021
140209,104356,REC,225,0,225,0,0,0,Thu Oct 21 21:36:06 2021
140206,104355,REC,450,0,450,0,0,0,Thu Oct 21 21:36:06 2021
140198,104351,MOF,137,137,0,0,20211021,2,Thu Oct 21 21:36:06 2021
140195,104350,HLD,178,0,178,0,20211007,39,Thu Oct 21 21:36:06 2021
140162,104339,MOF,18,18,0,0,20211021,2,Thu Oct 21 21:36:06 2021
140153,104336,MOF,31,21,10,0,20211021,1,Thu Oct 21 21:36:06 2021
140150,104335,MOF,8,8,0,0,20211021,1,Thu Oct 21 21:36:06 2021
140141,104332,HLD,2,0,2,0,20210911,1,Thu Oct 21 21:36:06 2021
140126,104327,XTR,3069,0,3069,0,0,0,Thu Oct 21 21:36:06 2021
140117,104324,REC,475,0,475,0,0,0,Thu Oct 21 21:36:06 2021
140114,104323,REC,550,0,550,0,0,0,Thu Oct 21 21:36:06 2021
140108,104321,HLD,1,0,1,0,20210917,1,Thu Oct 21 21:36:06 2021
140104,104320,MOF,220,220,0,0,20211021,15,Thu Oct 21 21:36:06 2021
140105,104320,OFF,1083,0,1083,0,0,0,Thu Oct 21 21:36:06 2021
140099,104317,MOF,607,179,428,0,20211021,10,Thu Oct 21 21:36:06 2021
140051,104301,MOF,2,2,0,0,20211011,2,Thu Oct 21 21:36:06 2021
140027,104293,MOF,2,1,1,0,0,0,Thu Oct 21 21:36:06 2021
139992,104280,HLD,20,0,20,0,20210907,30,Thu Oct 21 21:36:06 2021
139976,104272,MOF,2,2,0,0,20211014,9,Thu Oct 21 21:36:06 2021
139973,104271,MOF,32,32,0,0,20211020,2,Thu Oct 21 21:36:06 2021
139964,104262,MOF,1,1,0,0,0,0,Thu Oct 21 21:36:06 2021
139951,104251,XTR,1620,0,1620,0,0,0,Thu Oct 21 21:36:06 2021
139935,104245,HLD,1,0,1,0,20210908,40,Thu Oct 21 21:36:06 2021
139922,104239,MOF,555,14,541,0,20211021,33,Thu Oct 21 21:36:06 2021
139882,104228,MOF,185,185,0,0,20211021,7,Thu Oct 21 21:36:06 2021
139875,104226,REC,1080,99,981,0,0,0,Thu Oct 21 21:36:06 2021
139845,104216,MOF,1,1,0,0,20211014,3,Thu Oct 21 21:36:06 2021
139827,104210,HLD,65,0,65,0,20211001,8,Thu Oct 21 21:36:06 2021
139768,104183,MOF,4,4,0,0,0,0,Thu Oct 21 21:36:06 2021
139765,104182,XTR,2160,0,2160,0,0,0,Thu Oct 21 21:36:06 2021
139759,104180,MOF,1,1,0,0,0,0,Thu Oct 21 21:36:06 2021
139941,104172,MOF,20,20,0,0,20211020,3,Thu Oct 21 21:36:06 2021
139944,104150,MOF,867,622,245,0,20211019,108,Thu Oct 21 21:36:06 2021
139636,104125,HLD,3,0,3,0,20210828,33,Thu Oct 21 21:36:06 2021
142315,104119,MOF,1530,0,1530,0,0,0,Thu Oct 21 21:36:06 2021
139615,104116,XTR,2880,0,2880,0,0,0,Thu Oct 21 21:36:06 2021
139594,104108,MOF,47,19,28,0,20211021,8,Thu Oct 21 21:36:06 2021
139557,104093,MOF,5,5,0,0,20211018,1,Thu Oct 21 21:36:06 2021
139532,104085,MOF,87,87,0,0,20211021,4,Thu Oct 21 21:36:06 2021
139529,104084,MOF,1,1,0,0,20211011,2,Thu Oct 21 21:36:06 2021
139497,104074,MOF,1,1,0,0,20211012,0,Thu Oct 21 21:36:06 2021
139494,104073,MOF,2,0,2,0,0,0,Thu Oct 21 21:36:06 2021
139475,104064,MOF,1,1,0,0,0,0,Thu Oct 21 21:36:06 2021
139417,104044,MOF,3,3,0,0,0,0,Thu Oct 21 21:36:06 2021
139411,104042,MOF,10,10,0,0,20211012,1,Thu Oct 21 21:36:06 2021
139307,103991,MOF,1,0,1,0,0,0,Thu Oct 21 21:36:06 2021
139271,103979,MOF,33,33,0,0,20211021,1,Thu Oct 21 21:36:06 2021
139265,103977,REC,1025,0,1025,0,0,0,Thu Oct 21 21:36:06 2021
139257,103974,XTR,3276,0,3276,0,0,0,Thu Oct 21 21:36:06 2021
139207,103958,MOF,9,6,3,0,0,0,Thu Oct 21 21:36:06 2021
139204,103957,MOF,13,2,11,0,0,0,Thu Oct 21 21:36:06 2021
139201,103956,REC,1620,451,1169,0,0,0,Thu Oct 21 21:36:06 2021
139198,103955,MOF,20,20,0,0,20211014,3,Thu Oct 21 21:36:06 2021
139181,103949,REC,1776,0,1776,0,0,0,Thu Oct 21 21:36:06 2021
139178,103948,REC,1025,0,1025,0,0,0,Thu Oct 21 21:36:06 2021
139166,103944,HLD,200,0,200,0,20210818,200,Thu Oct 21 21:36:06 2021
139163,103943,REC,1620,109,1511,0,0,0,Thu Oct 21 21:36:06 2021
139160,103942,MOF,2203,0,2203,8.82,20211020,2,Thu Oct 21 21:36:06 2021
139142,103936,MOF,2262,227,2035,7.76,20211021,6,Thu Oct 21 21:36:06 2021
139139,103935,MOF,731,39,692,7.76,20211021,6,Thu Oct 21 21:36:06 2021
139136,103934,MOF,992,107,885,6.96,20211021,6,Thu Oct 21 21:36:06 2021
139127,103931,REC,450,93,357,0,0,0,Thu Oct 21 21:36:06 2021
139124,103930,REC,475,0,475,0,0,0,Thu Oct 21 21:36:06 2021
139083,103917,MOF,5,5,0,9.97,20211013,4,Thu Oct 21 21:36:06 2021
139074,103914,HLD,31,0,31,0,20210903,12,Thu Oct 21 21:36:06 2021
139022,103897,HLD,2,0,2,0,20211004,19,Thu Oct 21 21:36:06 2021
138950,103873,MOF,306,17,289,0,20211021,2,Thu Oct 21 21:36:06 2021
138947,103872,MOF,210,9,201,0,20211021,1,Thu Oct 21 21:36:06 2021
138869,103837,MOF,939,0,939,0,20211021,30,Thu Oct 21 21:36:06 2021
138860,103834,MOF,405,16,389,0,20211021,1,Thu Oct 21 21:36:06 2021
138857,103833,REC,1025,0,1025,0,0,0,Thu Oct 21 21:36:06 2021
138836,103826,XTR,2698,0,2698,0,0,0,Thu Oct 21 21:36:06 2021
138760,103801,MOF,5,5,0,0,20211020,40,Thu Oct 21 21:36:06 2021
138718,103787,REC,1025,0,1025,0,0,0,Thu Oct 21 21:36:06 2021
138715,103786,MOF,20,20,0,0,20211012,2,Thu Oct 21 21:36:06 2021
138709,103784,MOF,6,3,3,0,20211015,0,Thu Oct 21 21:36:06 2021
138670,103770,MOF,2,2,0,0,0,0,Thu Oct 21 21:36:06 2021
138643,103761,HLD,1308,0,1308,0,20210809,200,Thu Oct 21 21:36:06 2021
138640,103760,MOF,6,3,3,0,0,0,Thu Oct 21 21:36:06 2021
138637,103759,MOF,41,41,0,0,20211021,2,Thu Oct 21 21:36:06 2021
138622,103754,REC,1025,0,1025,0,0,0,Thu Oct 21 21:36:06 2021
138619,103753,MOF,7,7,0,0,20211021,8,Thu Oct 21 21:36:06 2021
138610,103750,HLD,25,0,25,0,20211004,7,Thu Oct 21 21:36:06 2021
138557,103732,HLD,149,0,149,0,20210817,400,Thu Oct 21 21:36:06 2021
138539,103726,REC,1025,0,1025,0,0,0,Thu Oct 21 21:36:06 2021
138536,103725,REC,1025,0,1025,0,0,0,Thu Oct 21 21:36:06 2021
138521,103720,MOF,2,2,0,0,0,0,Thu Oct 21 21:36:06 2021
138482,103707,MOF,1,1,0,0,0,0,Thu Oct 21 21:36:06 2021
138436,103692,HLD,8,0,8,0,20210824,3,Thu Oct 21 21:36:06 2021
138406,103682,MOF,357,66,291,0,20211021,2,Thu Oct 21 21:36:06 2021
138403,103681,XTR,1728,0,1728,0,0,0,Thu Oct 21 21:36:06 2021
138400,103680,MOF,838,35,803,0,20211021,4,Thu Oct 21 21:36:06 2021
138397,103679,REC,1025,0,1025,0,0,0,Thu Oct 21 21:36:06 2021
141318,103664,MOF,1232,634,598,0,20211021,400,Thu Oct 21 21:36:06 2021
138344,103660,DIS,3,3,0,0,20210803,3,Thu Oct 21 21:36:06 2021
138336,103658,REC,1025,0,1025,0,0,0,Thu Oct 21 21:36:06 2021
138327,103655,HLD,34,0,34,0,20210802,25,Thu Oct 21 21:36:06 2021
138312,103650,MOF,711,392,319,0,20211021,100,Thu Oct 21 21:36:06 2021
138297,103645,MOF,728,72,656,0,20211021,167,Thu Oct 21 21:36:06 2021
140318,103632,MOF,183,183,0,0,20211021,25,Thu Oct 21 21:36:06 2021
138224,103620,DIS,4,4,0,0,20210730,1,Thu Oct 21 21:36:06 2021
138216,103618,HLD,2,0,2,0,20210803,14,Thu Oct 21 21:36:06 2021
138207,103615,HLD,24,0,24,0,20210803,4,Thu Oct 21 21:36:06 2021
138204,103614,MOF,961,28,933,8.82,20211021,4,Thu Oct 21 21:36:06 2021
138191,103609,HLD,2,0,2,0,20210727,40,Thu Oct 21 21:36:06 2021
138178,103605,MOF,858,136,722,22.98,20211021,4,Thu Oct 21 21:36:06 2021
138175,103604,MOF,1831,223,1608,16.32,20211021,2,Thu Oct 21 21:36:06 2021
138166,103601,REC,555,0,555,0,20210812,470,Thu Oct 21 21:36:06 2021
138163,103600,MOF,299,68,231,0,20211021,1,Thu Oct 21 21:36:06 2021
138157,103596,MOF,572,35,537,9.75,20211021,2,Thu Oct 21 21:36:06 2021
138154,103595,REC,288,288,0,0,0,0,Thu Oct 21 21:36:06 2021
138151,103594,REC,960,0,960,0,0,0,Thu Oct 21 21:36:06 2021
138148,103593,REC,560,436,124,0,0,0,Thu Oct 21 21:36:06 2021
138139,103590,HLD,1,0,1,0,20210804,40,Thu Oct 21 21:36:06 2021
139943,103568,MOF,239,239,0,0,20211019,1,Thu Oct 21 21:36:06 2021
138005,103542,MOF,2,0,2,0,20211014,0,Thu Oct 21 21:36:06 2021
137994,103538,HLD,26,0,26,0,0,0,Thu Oct 21 21:36:06 2021
139261,103537,MOF,1046,30,1016,0,20211020,10,Thu Oct 21 21:36:06 2021
137975,103531,MOF,1,1,0,0,0,0,Thu Oct 21 21:36:06 2021
137918,103512,HLD,62,0,62,0,20210726,7,Thu Oct 21 21:36:06 2021
137917,103511,XTR,30,0,30,0,0,0,Thu Oct 21 21:36:06 2021
137914,103510,XTR,590,0,590,0,0,0,Thu Oct 21 21:36:06 2021
137900,103506,MOF,168,168,0,0,20211021,3,Thu Oct 21 21:36:06 2021
138814,103492,PAN,755,0,755,0,20211015,2761,Thu Oct 21 21:36:06 2021
137893,103492,REC,1826,0,1826,0,20210909,3179,Thu Oct 21 21:36:06 2021
137827,103482,MOF,2146,362,1784,0,20211021,30,Thu Oct 21 21:36:06 2021
137792,103470,REC,1313,443,870,0,0,0,Thu Oct 21 21:36:06 2021
137739,103452,HLD,5,0,5,0,20210716,16,Thu Oct 21 21:36:06 2021
137733,103450,REC,1025,936,89,0,0,0,Thu Oct 21 21:36:06 2021
137695,103435,REC,254,0,254,0,0,0,Thu Oct 21 21:36:06 2021
137692,103434,REC,28,0,28,0,0,0,Thu Oct 21 21:36:06 2021
137685,103432,REC,128,128,0,0,0,0,Thu Oct 21 21:36:06 2021
137682,103431,REC,3311,1334,1977,0,20211021,201,Thu Oct 21 21:36:06 2021
137673,103428,MOF,20,20,0,0,20211021,9,Thu Oct 21 21:36:06 2021
137656,103422,HLD,2,0,2,0,20210716,42,Thu Oct 21 21:36:06 2021
140718,103414,MOF,30,30,0,0,20211021,1,Thu Oct 21 21:36:06 2021
137618,103409,DIS,4,4,0,0,20210715,26,Thu Oct 21 21:36:06 2021
137586,103399,MOF,3,3,0,0,20211021,1,Thu Oct 21 21:36:06 2021
137564,103392,MOF,1250,52,1198,0,20211021,2,Thu Oct 21 21:36:06 2021
137536,103382,HLD,88,0,88,0,20210714,40,Thu Oct 21 21:36:06 2021
137481,103364,XTR,1518,0,1518,0,0,0,Thu Oct 21 21:36:06 2021
137451,103354,MOF,168,7,161,0,20211021,1,Thu Oct 21 21:36:06 2021
137418,103343,HLD,62,0,62,0,20210709,40,Thu Oct 21 21:36:06 2021
137393,103335,MOF,1341,122,1219,9.48,20211021,12,Thu Oct 21 21:36:06 2021
137387,103333,MOF,426,293,133,10.81,20211021,1,Thu Oct 21 21:36:06 2021
137384,103332,MOF,209,90,119,10.81,20211021,1,Thu Oct 21 21:36:06 2021
137381,103331,MOF,270,89,181,10.81,20211021,1,Thu Oct 21 21:36:06 2021
137354,103320,REC,415,413,2,0,0,0,Thu Oct 21 21:36:06 2021
137346,103318,REC,396,389,7,0,0,0,Thu Oct 21 21:36:06 2021
137337,103315,HLD,81,0,81,0,20210818,5,Thu Oct 21 21:36:06 2021
137331,103313,HLD,90,0,90,0,20210708,15,Thu Oct 21 21:36:06 2021
137293,103299,XTR,3276,0,3276,0,0,0,Thu Oct 21 21:36:06 2021
137197,103267,HLD,25,0,25,0,20210724,25,Thu Oct 21 21:36:06 2021
137173,103259,MOF,51,6,45,0,20211020,5,Thu Oct 21 21:36:06 2021
137089,103240,MOF,69,69,0,0,20211021,4,Thu Oct 21 21:36:06 2021
136935,103184,MOF,20,20,0,0,20211021,1,Thu Oct 21 21:36:06 2021
136929,103182,MOF,1,1,0,0,20210922,1,Thu Oct 21 21:36:06 2021
136896,103170,HLD,852,0,852,0,20210709,852,Thu Oct 21 21:36:06 2021
136874,103163,XTR,3276,0,3276,0,0,0,Thu Oct 21 21:36:06 2021
136652,103090,REC,436,436,0,0,0,0,Thu Oct 21 21:36:06 2021
137109,103070,MOF,2,2,0,0,20211021,2,Thu Oct 21 21:36:06 2021
136567,103062,REC,827,443,384,0,0,0,Thu Oct 21 21:36:06 2021
141543,103059,DIS,66,0,66,0,20211021,3,Thu Oct 21 21:36:06 2021
136558,103059,MOF,763,28,735,0,20211019,5,Thu Oct 21 21:36:06 2021
136549,103056,MOF,4,4,0,0,20211021,8,Thu Oct 21 21:36:06 2021
136534,103051,REC,96,95,1,0,0,0,Thu Oct 21 21:36:06 2021
136531,103050,REC,300,105,195,0,0,0,Thu Oct 21 21:36:06 2021
136513,103044,REC,120,0,120,0,0,0,Thu Oct 21 21:36:06 2021
136495,103038,MOF,12,12,0,0,20211021,1,Thu Oct 21 21:36:06 2021
136442,103020,MOF,32,32,0,0,20211021,10,Thu Oct 21 21:36:06 2021
136417,103011,MOF,144,32,112,0,20211021,50,Thu Oct 21 21:36:06 2021
136368,102995,MOF,878,64,814,0,20211021,2,Thu Oct 21 21:36:06 2021
136348,102989,MOF,271,261,10,0,20211021,5,Thu Oct 21 21:36:06 2021
141544,102921,DIS,99,0,99,0,20211021,1,Thu Oct 21 21:36:06 2021
136167,102921,MOF,1947,40,1907,0,20211021,2,Thu Oct 21 21:36:06 2021
136164,102920,XTR,590,0,590,0,0,0,Thu Oct 21 21:36:06 2021
136108,102901,MOF,46,3,43,0,20211021,1,Thu Oct 21 21:36:06 2021
136105,102900,MOF,10,10,0,0,20211014,50,Thu Oct 21 21:36:06 2021
136102,102899,MOF,26,26,0,0,20211021,2,Thu Oct 21 21:36:06 2021
136090,102895,THG,960,0,960,0,0,0,Thu Oct 21 21:36:06 2021
136080,102893,THG,100,100,0,0,20211008,12,Thu Oct 21 21:36:06 2021
136027,102876,XTR,1180,0,1180,0,0,0,Thu Oct 21 21:36:06 2021
135988,102863,MOF,202,138,64,0,20211021,4,Thu Oct 21 21:36:06 2021
135915,102839,MOF,1935,86,1849,0,20211021,70,Thu Oct 21 21:36:06 2021
141208,102830,DIS,66,0,66,0,20211021,4,Thu Oct 21 21:36:06 2021
135890,102830,MOF,897,192,705,0,20211019,72,Thu Oct 21 21:36:06 2021
137116,102800,MOF,22,22,0,0,20211021,2,Thu Oct 21 21:36:06 2021
135748,102782,XTR,1840,0,1840,0,20210921,90,Thu Oct 21 21:36:06 2021
135725,102774,MOF,536,291,245,0,20211021,2,Thu Oct 21 21:36:06 2021
135569,102722,REC,117,116,1,0,0,0,Thu Oct 21 21:36:06 2021
135563,102720,REC,9,0,9,0,0,0,Thu Oct 21 21:36:06 2021
135452,102681,MOF,21,0,21,0,20211021,1,Thu Oct 21 21:36:06 2021
137108,102675,MOF,35,35,0,0,20211021,5,Thu Oct 21 21:36:06 2021
136441,102672,MOF,425,108,317,0,20211021,1,Thu Oct 21 21:36:06 2021
137105,102641,MOF,1515,0,1515,0,0,0,Thu Oct 21 21:36:06 2021
135065,102545,MOF,66,19,47,26.25,20211021,5,Thu Oct 21 21:36:06 2021
135062,102544,MOF,846,22,824,26.25,20211021,1,Thu Oct 21 21:36:06 2021
134995,102522,XTR,2711,0,2711,0,20210921,234,Thu Oct 21 21:36:06 2021
134970,102513,MOF,203,53,150,0,20211014,32,Thu Oct 21 21:36:06 2021
134953,102506,XTR,385,385,0,0,20211021,144,Thu Oct 21 21:36:06 2021
142272,102473,DIS,60,0,60,0,20211021,3,Thu Oct 21 21:36:06 2021
137102,102473,MOF,1245,0,1245,0,0,0,Thu Oct 21 21:36:06 2021
134800,102457,THG,960,0,960,0,0,0,Thu Oct 21 21:36:06 2021
134785,102452,THG,960,224,736,0,0,0,Thu Oct 21 21:36:06 2021
134753,102442,MOF,422,158,264,0,20211019,90,Thu Oct 21 21:36:06 2021
134705,102423,MOF,31,31,0,0,20211021,1,Thu Oct 21 21:36:06 2021
137106,102422,MOF,351,114,237,0,20211021,40,Thu Oct 21 21:36:06 2021
134690,102418,MOF,10,10,0,0,20211020,2,Thu Oct 21 21:36:06 2021
134600,102388,MOF,7,7,0,0,20211021,1,Thu Oct 21 21:36:06 2021
134525,102360,MOF,1772,155,1617,0,20211019,117,Thu Oct 21 21:36:06 2021
134427,102326,XTR,1720,0,1720,0,0,0,Thu Oct 21 21:36:06 2021
134421,102324,MOF,469,75,394,10.57,20211021,6,Thu Oct 21 21:36:06 2021
137104,102295,MOF,364,364,0,0,20211019,85,Thu Oct 21 21:36:06 2021
134228,102260,REC,337,334,3,0,0,0,Thu Oct 21 21:36:06 2021
133716,102083,MOF,770,366,404,0,20211021,3,Thu Oct 21 21:36:06 2021
133549,102033,MOF,1257,42,1215,0,20211021,1,Thu Oct 21 21:36:06 2021
133532,102027,MOF,1353,274,1079,0,20211021,5,Thu Oct 21 21:36:06 2021
133526,102025,MOF,15,15,0,0,20211019,2,Thu Oct 21 21:36:06 2021
133428,101990,MOF,15,15,0,0,20211021,1,Thu Oct 21 21:36:06 2021
133376,101967,MOF,1074,112,962,0,20211021,15,Thu Oct 21 21:36:06 2021
133303,101943,MOF,31,24,7,0,20211021,2,Thu Oct 21 21:36:06 2021
132998,101839,MOF,2,2,0,0,20211015,3,Thu Oct 21 21:36:06 2021
132983,101834,MOF,244,0,244,0,20211021,3,Thu Oct 21 21:36:06 2021
132866,101789,DOK,371,0,371,0,0,0,Thu Oct 21 21:36:06 2021
132845,101789,HLD,1365,0,1365,0,20211013,1146,Thu Oct 21 21:36:06 2021
132501,101672,MOF,6,6,0,0,20211012,2,Thu Oct 21 21:36:06 2021
132382,101630,MOF,1239,15,1224,0,20211019,10,Thu Oct 21 21:36:06 2021
131756,101402,MOF,2551,48,2503,0,20211021,10,Thu Oct 21 21:36:06 2021
131647,101359,MOF,290,5,285,0,20211007,2,Thu Oct 21 21:36:06 2021
131304,101244,MOF,79,7,72,0,20211005,20,Thu Oct 21 21:36:06 2021
131232,101220,HLD,1,0,1,0,20210317,166,Thu Oct 21 21:36:06 2021
131146,101193,MOF,1060,77,983,0,20211021,3,Thu Oct 21 21:36:06 2021
130949,101121,MOF,1,1,0,0,20211020,1,Thu Oct 21 21:36:06 2021
130713,101030,MOF,1,0,1,0,20211021,0,Thu Oct 21 21:36:06 2021
130692,101023,MOF,271,1,270,0,20211013,1,Thu Oct 21 21:36:06 2021
130619,101000,MOF,1416,197,1219,0,20211021,1,Thu Oct 21 21:36:06 2021
130546,100963,MOF,2675,143,2532,10,20211021,10,Thu Oct 21 21:36:06 2021
130543,100962,MOF,708,9,699,24,20211021,1,Thu Oct 21 21:36:06 2021
130540,100961,MOF,8,8,0,30,20211021,1,Thu Oct 21 21:36:06 2021
130537,100960,MOF,812,53,759,30,20211021,5,Thu Oct 21 21:36:06 2021
130501,100948,MOF,1283,688,595,0,20211021,75,Thu Oct 21 21:36:06 2021
130399,100915,MOF,2333,133,2200,9.99,20211021,15,Thu Oct 21 21:36:06 2021
130189,100845,MOF,238,74,164,9.99,20211021,10,Thu Oct 21 21:36:06 2021
130159,100835,MOF,110,27,83,0,20211020,4,Thu Oct 21 21:36:06 2021
130143,100829,XTR,1740,0,1740,0,0,0,Thu Oct 21 21:36:06 2021
130113,100820,XTR,1786,0,1786,0,0,0,Thu Oct 21 21:36:06 2021
130054,100802,MOF,4,4,0,0,0,0,Thu Oct 21 21:36:06 2021
129991,100778,MOF,18,0,18,0,20210927,1,Thu Oct 21 21:36:06 2021
129971,100769,REC,611,147,464,0,0,0,Thu Oct 21 21:36:06 2021
129962,100766,MOF,31,28,3,0,20211021,0,Thu Oct 21 21:36:06 2021
129906,100746,MOF,773,125,648,0,20211021,100,Thu Oct 21 21:36:06 2021
129695,100677,MOF,116,116,0,0,20211021,1,Thu Oct 21 21:36:06 2021
129623,100651,MOF,966,43,923,0,20211021,8,Thu Oct 21 21:36:06 2021
129406,100571,XTR,2338,0,2338,9.99,0,0,Thu Oct 21 21:36:06 2021
129401,100570,MOF,347,2,345,15.5,20211015,6,Thu Oct 21 21:36:06 2021
140258,100570,REC,1,0,1,0,0,0,Thu Oct 21 21:36:06 2021
129361,100557,MOF,889,7,882,10.23,20211020,1,Thu Oct 21 21:36:06 2021
129183,100501,MOF,2159,49,2110,0,20211020,30,Thu Oct 21 21:36:06 2021
129171,100497,MOF,46,46,0,0,20211021,2,Thu Oct 21 21:36:06 2021
129144,100488,MOF,247,126,121,9.99,20211021,15,Thu Oct 21 21:36:06 2021
128594,100307,MOF,10,10,0,0,20211013,3,Thu Oct 21 21:36:06 2021
128564,100297,MOF,582,60,522,15.25,20211021,8,Thu Oct 21 21:36:06 2021
128245,100187,MOF,229,75,154,11.2,20211021,3,Thu Oct 21 21:36:06 2021
128237,100185,MOF,60,60,0,0,20211021,1,Thu Oct 21 21:36:06 2021
128232,100184,MOF,2,2,0,0,0,0,Thu Oct 21 21:36:06 2021
128203,100173,MOF,37,37,0,0,20211021,5,Thu Oct 21 21:36:06 2021
128147,100155,MOF,784,38,746,10.48,20211021,5,Thu Oct 21 21:36:06 2021
136069,100148,XTR,1792,0,1792,0,20210921,112,Thu Oct 21 21:36:06 2021
127816,100024,MOF,402,19,383,0,20211021,8,Thu Oct 21 21:36:06 2021
127810,100022,MOF,877,375,502,0,20211019,112,Thu Oct 21 21:36:06 2021
126371,99474,MOF,215,57,158,0,20211021,5,Thu Oct 21 21:36:06 2021
124651,98829,MOF,31,31,0,0,20211021,2,Thu Oct 21 21:36:06 2021
141545,98729,DIS,66,0,66,0,20211021,1,Thu Oct 21 21:36:06 2021
124350,98729,MOF,171,66,105,0,20211020,1,Thu Oct 21 21:36:06 2021
119295,96897,HLD,804,0,804,0,20211020,1,Thu Oct 21 21:36:06 2021
118310,96141,HLD,497,0,497,0,20210630,3,Thu Oct 21 21:36:06 2021
118309,96035,HLD,108,0,108,0,20201210,1,Thu Oct 21 21:36:06 2021
137353,94601,PAN,270,108,162,0,20211015,162,Thu Oct 21 21:36:06 2021
102545,90599,PAN,370,0,370,0,20211015,793,Thu Oct 21 21:36:06 2021
101791,90026,MOF,2295,2295,0,0,20211021,375,Thu Oct 21 21:36:06 2021
101116,88701,OFF,26,26,0,0,20211021,650,Thu Oct 21 21:36:06 2021
101125,88699,OFF,202,202,0,0,20211021,41,Thu Oct 21 21:36:06 2021
101118,88692,OFF,179,179,0,0,20211021,80,Thu Oct 21 21:36:06 2021
101117,88691,OFF,553,553,0,0,20211021,225,Thu Oct 21 21:36:06 2021
101115,88690,OFF,1324,1324,0,0,20211021,300,Thu Oct 21 21:36:06 2021
101114,88689,OFF,57,57,0,0,20211021,225,Thu Oct 21 21:36:06 2021
101112,88687,OFF,706,706,0,0,20211021,19,Thu Oct 21 21:36:06 2021
101111,88686,OFF,295,295,0,0,20211021,10,Thu Oct 21 21:36:06 2021
139052,86511,PAN,1110,0,1110,0,20210929,358,Thu Oct 21 21:36:06 2021
97383,86346,HLD,4830,0,4830,0,20211019,1965,Thu Oct 21 21:36:06 2021
97063,86075,MOF,39,12,27,0,20211021,1,Thu Oct 21 21:36:06 2021
94212,83687,PAN,398,0,398,0,20211015,3768,Thu Oct 21 21:36:06 2021
101139,83062,PAN,400,0,400,0,20210513,785,Thu Oct 21 21:36:06 2021
93190,83062,REC,1330,0,1330,0,20211019,136,Thu Oct 21 21:36:06 2021
139878,82819,PAN,280,0,280,0,20210902,20,Thu Oct 21 21:36:06 2021
96001,82249,HLD,300,0,300,0,20210531,809,Thu Oct 21 21:36:06 2021
91397,81457,MOF,1048,1048,0,0,20211021,40,Thu Oct 21 21:36:06 2021
90536,80820,MOF,50,25,25,0,20211008,25,Thu Oct 21 21:36:06 2021
95899,78799,HLD,5611,0,5611,0,20211020,841,Thu Oct 21 21:36:06 2021
95901,78741,HLD,4171,0,4171,0,20211004,681,Thu Oct 21 21:36:06 2021
88260,78739,REC,344,0,344,0,20211021,532,Thu Oct 21 21:36:06 2021
95902,78735,HLD,3699,0,3699,0,20211005,100,Thu Oct 21 21:36:06 2021
95903,78263,HLD,9359,0,9359,0,20211020,243,Thu Oct 21 21:36:06 2021
87323,77867,REC,6555,0,6555,0,20211020,867,Thu Oct 21 21:36:06 2021
97816,77864,HLD,248,0,248,0,20190808,772,Thu Oct 21 21:36:06 2021
86844,77443,REC,18885,0,18885,0,20211020,2666,Thu Oct 21 21:36:06 2021
86023,76712,REC,10198,0,10198,0,20211020,436,Thu Oct 21 21:36:06 2021
80400,71654,MOF,500,340,160,0,20211021,50,Thu Oct 21 21:36:06 2021
80399,71653,MOF,783,570,213,0,20211021,80,Thu Oct 21 21:36:06 2021
80398,71652,MOF,78,28,50,0,20211021,8,Thu Oct 21 21:36:06 2021
76800,68452,MOF,44448,10557,33891,0,20211021,40,Thu Oct 21 21:36:06 2021
76799,68451,MOF,4664,2757,1907,0,20211021,222,Thu Oct 21 21:36:06 2021
117739,68296,HLD,2953,0,2953,0,20210901,560,Thu Oct 21 21:36:06 2021
98845,64920,PAN,10167,0,10167,0,20211015,8773,Thu Oct 21 21:36:06 2021
105931,64522,DOK,3902,0,3902,0,0,0,Thu Oct 21 21:36:06 2021
95950,64522,HLD,3601,0,3601,0,20211020,40,Thu Oct 21 21:36:06 2021
69804,62227,MOF,932,737,195,0,20211021,7,Thu Oct 21 21:36:06 2021
69699,62127,MOF,11315,1675,9640,0,20211021,20,Thu Oct 21 21:36:06 2021
69082,61592,REC,1460,0,1460,0,20211015,794,Thu Oct 21 21:36:06 2021
97028,60503,HLD,14148,0,14148,0,20210916,567,Thu Oct 21 21:36:06 2021
66751,59496,REC,172,0,172,0,20211021,225,Thu Oct 21 21:36:06 2021
67255,58379,MOF,730,730,0,0,20211021,20,Thu Oct 21 21:36:06 2021
66472,56335,PAN,534,0,534,0,20211015,385,Thu Oct 21 21:36:06 2021
67881,55199,PAN,350,0,350,0,20211005,792,Thu Oct 21 21:36:06 2021
95949,55119,HLD,1385,0,1385,0,20211005,125,Thu Oct 21 21:36:06 2021
105082,54822,DOK,770,0,770,0,0,0,Thu Oct 21 21:36:06 2021
104900,54705,DOK,8391,0,8391,0,0,0,Thu Oct 21 21:36:06 2021
95910,54705,HLD,2560,0,2560,0,20211019,680,Thu Oct 21 21:36:06 2021
101165,52122,PAN,408,0,408,0,20211015,846,Thu Oct 21 21:36:06 2021
58427,52122,REC,9769,0,9769,0,20211021,5454,Thu Oct 21 21:36:06 2021
58058,51777,MOF,197,147,50,0,20211021,6,Thu Oct 21 21:36:06 2021
56547,50428,MOF,352,304,48,0,20211021,1,Thu Oct 21 21:36:06 2021
56546,50427,MOF,179,146,33,0,20211021,1,Thu Oct 21 21:36:06 2021
56545,50426,MOF,141,98,43,0,20211021,6,Thu Oct 21 21:36:06 2021
56404,50294,MOF,39,39,0,0,20211021,1,Thu Oct 21 21:36:06 2021
73903,48858,REC,4109,0,4109,0,20211008,900,Thu Oct 21 21:36:06 2021
104778,48856,DOK,454,0,454,0,0,0,Thu Oct 21 21:36:06 2021
54103,48270,MOF,1148,466,682,0,20211021,4,Thu Oct 21 21:36:06 2021
53311,47576,MOF,131,81,50,0,20211021,11,Thu Oct 21 21:36:06 2021
95928,47549,HLD,3710,0,3710,0,20211020,38,Thu Oct 21 21:36:06 2021
53276,47544,MOF,81,56,25,0,20211021,11,Thu Oct 21 21:36:06 2021
53165,47437,MOF,25,25,0,0,20211008,25,Thu Oct 21 21:36:06 2021
53162,47434,MOF,626,429,197,0,20211021,5,Thu Oct 21 21:36:06 2021
53158,47430,MOF,511,379,132,0,20211021,40,Thu Oct 21 21:36:06 2021
53157,47429,MOF,65,65,0,0,20211021,16,Thu Oct 21 21:36:06 2021
53155,47427,MOF,19,19,0,0,20211021,6,Thu Oct 21 21:36:06 2021
53147,47422,MOF,162,137,25,0,20211021,2,Thu Oct 21 21:36:06 2021
53143,47418,MOF,81,81,0,0,20211021,4,Thu Oct 21 21:36:06 2021
53138,47413,MOF,59,59,0,0,20211021,4,Thu Oct 21 21:36:06 2021
96292,47366,HLD,93,0,93,0,20210421,323,Thu Oct 21 21:36:06 2021
130509,46063,HLD,2102,0,2102,0,20210107,887,Thu Oct 21 21:36:06 2021
137352,45984,PAN,54,0,54,0,20211015,54,Thu Oct 21 21:36:06 2021
95911,45719,HLD,23632,0,23632,0,20211021,13,Thu Oct 21 21:36:06 2021
95890,45718,HLD,3972,0,3972,0,20211020,428,Thu Oct 21 21:36:06 2021
95892,45717,HLD,12843,0,12843,0,20211020,345,Thu Oct 21 21:36:06 2021
95894,45715,HLD,39996,0,39996,0,20211021,2063,Thu Oct 21 21:36:06 2021
76357,45713,PAN,789,0,789,0,20211015,1454,Thu Oct 21 21:36:06 2021
51201,45713,REC,9889,0,9889,0,20211021,4022,Thu Oct 21 21:36:06 2021
78729,44077,REC,1504,0,1504,0,20210907,110,Thu Oct 21 21:36:06 2021
78185,42836,REC,3348,0,3348,0,20211014,199,Thu Oct 21 21:36:06 2021
95893,42372,HLD,1698,0,1698,0,20211020,584,Thu Oct 21 21:36:06 2021
95891,42252,HLD,1159,0,1159,0,20211020,182,Thu Oct 21 21:36:06 2021
95907,40583,HLD,1131,0,1131,0,20210917,21,Thu Oct 21 21:36:06 2021
104558,39609,DOK,1036,0,1036,0,0,0,Thu Oct 21 21:36:06 2021
95889,39609,HLD,2847,0,2847,0,20211020,980,Thu Oct 21 21:36:06 2021
104893,33916,DOK,1406,0,1406,0,0,0,Thu Oct 21 21:36:06 2021
95895,33916,HLD,1062,0,1062,0,20211018,1970,Thu Oct 21 21:36:06 2021
135180,30949,PAN,652,0,652,0,20211015,914,Thu Oct 21 21:36:06 2021
27957,26066,REC,11210,0,11210,0,20211021,4255,Thu Oct 21 21:36:06 2021
95859,21185,HLD,501,0,501,0,20210609,1308,Thu Oct 21 21:36:06 2021
98482,21138,HLD,1227,0,1227,0,20210902,1020,Thu Oct 21 21:36:06 2021
66639,18042,PAN,625,0,625,0,20211015,426,Thu Oct 21 21:36:06 2021
100808,11359,HLD,2078,0,2078,0,20211008,680,Thu Oct 21 21:36:06 2021
102769,10672,PAN,1158,0,1158,0,20211015,4105,Thu Oct 21 21:36:06 2021
63027,10672,REC,1600,0,1600,0,20211019,2039,Thu Oct 21 21:36:06 2021
59311,8117,REC,190,0,190,0,20210301,616,Thu Oct 21 21:36:06 2021
46409,4011,REC,6593,0,6593,0,20211019,532,Thu Oct 21 21:36:06 2021
95880,3007,HLD,5144,0,5144,0,20211021,485,Thu Oct 21 21:36:06 2021
142136,2154,PAN,3520,0,3520,0,0,0,Thu Oct 21 21:36:06 2021
